"aa" = (/turf/space,/area/space)
"ab" = (/turf/simulated/wall/r_wall/prepainted,/area/space)
"ac" = (/turf/simulated/floor/tiled/techfloor,/area/space)
"ad" = (/turf/simulated/floor/tiled/techmaint,/area/space)
"ae" = (/obj/structure/bed/chair/shuttle/white{icon_state = "shuttle_chair_preview"; dir = 1},/turf/simulated/floor/tiled/techmaint,/area/space)
"af" = (/obj/effect/floor_decal/industrial/hatch/yellow,/obj/machinery/door/firedoor,/obj/machinery/door/airlock/hatch,/turf/simulated/floor/tiled/monotile,/area/space)
"ag" = (/obj/structure/bed/padded,/obj/machinery/light/small{dir = 1},/obj/item/weapon/bedsheet/red,/turf/simulated/floor/lino,/area/space)
"ah" = (/obj/machinery/light/small{dir = 4},/turf/simulated/floor/tiled/techmaint,/area/space)
"ai" = (/turf/simulated/floor/lino,/area/space)
"aj" = (/obj/effect/floor_decal/small_carpet{icon_state = "small_carpet"; dir = 5},/obj/structure/safe/floor,/turf/simulated/floor/lino,/area/space)
"ak" = (/obj/effect/floor_decal/industrial/hatch/yellow,/obj/machinery/door/firedoor{dir = 8},/obj/machinery/door/airlock/hatch,/turf/simulated/floor/tiled/monotile,/area/space)
"al" = (/obj/structure/bed/sofa/beige/left,/turf/simulated/floor/lino,/area/space)
"am" = (/mob/living/simple_animal/corgi{dir = 4; icon_state = "corgi"; name = "Ein"},/turf/simulated/floor/lino,/area/space)
"an" = (/obj/random/trash,/turf/simulated/floor/tiled/old_tile,/area/space)
"ao" = (/obj/machinery/disposal,/obj/effect/floor_decal/industrial/outline/yellow,/obj/machinery/light{dir = 1},/obj/effect/decal/cleanable/cobweb,/turf/simulated/floor/tiled/techmaint,/area/space)
"ap" = (/obj/machinery/newscaster{pixel_y = 30},/obj/random/trash,/turf/simulated/floor/tiled/techmaint,/area/space)
"aq" = (/obj/structure/fake_stairs/single{dir = 4},/obj/structure/railing/mapped,/obj/machinery/light/small{dir = 1},/turf/simulated/floor/lino,/area/space)
"ar" = (/obj/structure/catwalk,/obj/structure/railing/mapped{dir = 4},/obj/structure/railing/mapped,/turf/simulated/floor/lino,/area/space)
"as" = (/obj/machinery/computer/arcade,/obj/machinery/light/small{dir = 1},/obj/effect/decal/cleanable/cobweb2,/turf/simulated/floor/lino,/area/space)
"at" = (/obj/structure/closet/emcloset,/obj/effect/floor_decal/industrial/outline/yellow,/obj/machinery/light{dir = 1},/turf/simulated/floor/tiled/techmaint,/area/space)
"au" = (/obj/machinery/washing_machine,/obj/machinery/light{dir = 1},/obj/effect/floor_decal/corner/grey/diagonal,/turf/simulated/floor/tiled/techmaint,/area/space)
"av" = (/obj/structure/railing/mapped{dir = 4},/turf/simulated/floor/tiled/techmaint,/area/space)
"aw" = (/obj/effect/floor_decal/corner/grey/diagonal,/turf/simulated/floor/tiled/techmaint,/area/space)
"ax" = (/obj/structure/bed/sofa/beige/right,/obj/item/device/synthesized_instrument/guitar,/turf/simulated/floor/lino,/area/space)
"ay" = (/obj/structure/railing/mapped{dir = 8},/turf/simulated/floor/tiled/techmaint,/area/space)
"az" = (/obj/structure/fake_stairs/single{dir = 1},/obj/structure/railing/mapped{dir = 8},/obj/structure/railing/mapped{dir = 4},/turf/simulated/floor/lino,/area/space)
"aA" = (/obj/structure/railing/mapped{dir = 8},/turf/simulated/floor/lino,/area/space)
"aB" = (/obj/structure/railing/mapped{dir = 4},/turf/simulated/floor/lino,/area/space)
"aC" = (/obj/effect/floor_decal/industrial/warning{icon_state = "warning"; dir = 9},/turf/simulated/floor/tiled/techfloor,/area/space)
"aD" = (/obj/effect/floor_decal/industrial/warning{dir = 1; icon_state = "warning"},/turf/simulated/floor/tiled/techfloor,/area/space)
"aE" = (/obj/structure/bed/chair/wood/maple,/obj/effect/floor_decal/corner/grey/diagonal,/obj/effect/decal/cleanable/cobweb2,/turf/simulated/floor/tiled/techmaint,/area/space)
"aF" = (/obj/effect/floor_decal/industrial/warning{icon_state = "warning"; dir = 8},/turf/simulated/floor/tiled/techfloor,/area/space)
"aG" = (/obj/effect/floor_decal/industrial/warning{icon_state = "warning"; dir = 4},/turf/simulated/floor/tiled/techfloor,/area/space)
"aH" = (/obj/structure/fake_stairs/single,/obj/structure/railing/mapped{dir = 8},/obj/structure/railing/mapped{dir = 4},/turf/simulated/floor/lino,/area/space)
"aI" = (/obj/effect/floor_decal/industrial/warning{dir = 10; icon_state = "warning"},/turf/simulated/floor/tiled/techfloor,/area/space)
"aJ" = (/obj/effect/floor_decal/industrial/warning{icon_state = "warning"; dir = 2},/turf/simulated/floor/tiled/techfloor,/area/space)
"aK" = (/obj/effect/floor_decal/industrial/warning{dir = 6; icon_state = "warning"},/turf/simulated/floor/tiled/techfloor,/area/space)
"aL" = (/obj/effect/floor_decal/corner/grey/diagonal,/turf/simulated/floor/tiled/old_tile,/area/space)
"aM" = (/obj/structure/table/steel_reinforced,/obj/item/trash/plate,/obj/item/weapon/material/kitchen/utensil/spoon,/obj/item/weapon/material/kitchen/utensil/fork,/obj/item/weapon/material/knife/table,/obj/effect/floor_decal/corner/grey/diagonal,/turf/simulated/floor/tiled/old_tile,/area/space)
"aN" = (/obj/effect/floor_decal/industrial/warning{icon_state = "warning"; dir = 5},/obj/random/trash,/turf/simulated/floor/tiled/techfloor,/area/space)
"aO" = (/obj/structure/table/steel_reinforced,/obj/item/weapon/reagent_containers/food/drinks/glass2/coffeecup/metal,/obj/effect/floor_decal/corner/grey/diagonal,/turf/simulated/floor/tiled/old_tile,/area/space)
"aP" = (/obj/structure/table/rack,/obj/item/roller/ironingboard,/obj/item/weapon/ironingiron,/obj/machinery/light/small{dir = 1},/obj/effect/decal/cleanable/cobweb,/turf/simulated/floor/tiled/techmaint,/area/space)
"aQ" = (/obj/structure/table/steel_reinforced,/obj/machinery/microwave,/obj/effect/floor_decal/corner/grey/diagonal,/turf/simulated/floor/tiled/old_tile,/area/space)
"aR" = (/obj/structure/table/rack,/obj/item/weapon/mop,/obj/item/weapon/reagent_containers/glass/bucket/wood,/turf/simulated/floor/tiled/techmaint,/area/space)
"aS" = (/obj/random/trash,/turf/simulated/floor/tiled/techmaint,/area/space)
"aT" = (/turf/simulated/floor/plating,/area/space)
"aU" = (/obj/structure/railing/mapped{dir = 4},/obj/machinery/light,/turf/simulated/floor/tiled/techmaint,/area/space)
"aV" = (/obj/structure/railing/mapped{dir = 8},/obj/machinery/light,/turf/simulated/floor/tiled/techmaint,/area/space)
"aW" = (/obj/structure/hygiene/sink/kitchen{dir = 4; pixel_x = -21},/obj/effect/floor_decal/corner/grey/diagonal,/obj/random/trash,/turf/simulated/floor/tiled/techmaint,/area/space)
"aX" = (/obj/machinery/light,/obj/effect/floor_decal/corner/grey/diagonal,/obj/structure/closet/secure_closet/freezer/fridge,/turf/simulated/floor/tiled/techmaint,/area/space)
"aY" = (/obj/machinery/light/small{dir = 1},/obj/effect/decal/cleanable/cobweb2{icon_state = "cobweb2"; dir = 4},/turf/simulated/floor/tiled/techmaint,/area/space)
"aZ" = (/obj/effect/decal/cleanable/cobweb2{icon_state = "cobweb2"; dir = 1},/turf/simulated/floor/tiled/techmaint,/area/space)
"ba" = (/obj/effect/decal/cleanable/cobweb{icon_state = "cobweb1"; dir = 1},/turf/simulated/floor/tiled/techmaint,/area/space)
"bb" = (/obj/structure/closet/secure_closet/guncabinet,/turf/simulated/floor/tiled/techfloor/grid,/area/space)
"bc" = (/obj/machinery/computer,/obj/effect/floor_decal/spline/fancy/black/full,/turf/simulated/floor/plating,/area/space)
"bd" = (/obj/structure/railing/mapped{dir = 8},/obj/structure/closet/emcloset,/obj/effect/floor_decal/industrial/outline/yellow,/turf/simulated/floor/tiled/techmaint,/area/space)
"be" = (/obj/machinery/hologram/holopad/longrange,/turf/simulated/floor/lino,/area/space)
"bf" = (/obj/machinery/computer{dir = 4; icon_state = "computer"},/obj/effect/floor_decal/spline/fancy/black/cee{icon_state = "spline_fancy_cee"; dir = 1},/turf/simulated/floor/plating,/area/space)
"bg" = (/obj/structure/hygiene/shower{dir = 8; pixel_x = 12; pixel_y = 5},/obj/structure/curtain/open/shower,/obj/item/weapon/storage/mirror{pixel_y = 26},/turf/simulated/floor/tiled/old_cargo,/area/space)
"bh" = (/obj/structure/closet/emcloset,/obj/effect/floor_decal/spline/fancy/black/cee,/obj/machinery/light/small/red,/turf/simulated/floor/plating,/area/space)
"bj" = (/obj/structure/table/standard,/obj/effect/floor_decal/spline/fancy/black/cee,/obj/machinery/light/small/red,/turf/simulated/floor/plating,/area/space)
"bl" = (/obj/structure/bed,/obj/item/weapon/bedsheet,/turf/simulated/floor/tiled/techmaint,/area/space)
"bn" = (/obj/structure/table/woodentable/mahogany,/obj/item/weapon/material/ashtray/bronze,/turf/simulated/floor/lino,/area/space)
"bp" = (/obj/structure/hygiene/toilet{dir = 8},/obj/machinery/light/small{dir = 4},/turf/simulated/floor/tiled/old_tile,/area/space)
"bs" = (/obj/structure/navlight_shuttle{dir = 4},/turf/simulated/floor/reinforced/airless,/area/space)
"bv" = (/obj/machinery/computer{icon_state = "computer"; dir = 8},/obj/effect/floor_decal/spline/fancy/black/cee{icon_state = "spline_fancy_cee"; dir = 1},/turf/simulated/floor/plating,/area/space)
"bw" = (/obj/structure/navlight_shuttle/red,/turf/simulated/floor/reinforced/airless,/area/space)
"bx" = (/obj/structure/closet,/obj/machinery/light/small{dir = 1},/turf/simulated/floor/tiled/techmaint,/area/space)
"bz" = (/obj/effect/wallframe_spawn/reinforced,/turf/simulated/floor/plating,/area/space)
"bA" = (/turf/simulated/floor/reinforced/airless,/area/space)
"bE" = (/obj/machinery/atmospherics/unary/vent_pump/high_volume/airlock{dir = 4; id_tag = "level1_maintairlock1_pump"},/turf/simulated/floor/reinforced/airless,/area/space)
"bF" = (/obj/machinery/atmospherics/unary/engine{icon_state = "nozzle"; dir = 1},/turf/simulated/floor/reinforced/airless,/area/space)
"bG" = (/obj/machinery/atmospherics/unary/vent_pump/high_volume/airlock{dir = 8; id_tag = "level1_maintairlock1_pump"},/turf/simulated/floor/reinforced/airless,/area/space)
"bK" = (/obj/machinery/light/small{dir = 1},/turf/simulated/floor/tiled/techmaint,/area/space)
"bM" = (/obj/effect/floor_decal/small_carpet{dir = 10},/obj/structure/sign/poster/bay_50{pixel_y = 30},/turf/simulated/floor/tiled/techmaint,/area/space)
"bP" = (/obj/structure/table/woodentable/mahogany,/obj/item/weapon/reagent_containers/food/drinks/bottle/whiskey,/turf/simulated/floor/lino,/area/space)
"bQ" = (/obj/effect/floor_decal/small_carpet{dir = 8},/turf/simulated/floor/tiled/techmaint,/area/space)
"bR" = (/obj/structure/catwalk,/turf/simulated/floor/tiled/techmaint,/area/space)
"bS" = (/obj/machinery/alarm{dir = 4; pixel_x = -24},/obj/structure/catwalk,/turf/simulated/floor/tiled/techmaint,/area/space)
"bT" = (/obj/machinery/power/apc{dir = 4; name = "east bump"; pixel_x = 24},/obj/structure/catwalk,/turf/simulated/floor/tiled/techmaint,/area/space)
"bU" = (/obj/item/device/radio/intercom{dir = 8; pixel_x = 22},/obj/structure/catwalk,/turf/simulated/floor/tiled/techmaint,/area/space)
"bW" = (/obj/structure/catwalk,/obj/machinery/firealarm{dir = 8; pixel_x = -24},/turf/simulated/floor/tiled/techmaint,/area/space)
"bX" = (/obj/machinery/firealarm{dir = 4; pixel_x = 24},/turf/simulated/floor/tiled/techmaint,/area/space)
"bY" = (/obj/machinery/firealarm{dir = 8; pixel_x = -24},/turf/simulated/floor/tiled/techmaint,/area/space)

(1,1,1) = {"
aaaaaaaaaaaaaaaaaaaaaaaaaaaaaaaaaaaaaaaaaaaaaaaaaaaaaaaaaaaaaaaaaaaaaaaaaaaaaaaaaaaaaaaaaaaaaaaaaaaaaaaaaaaaaaaaaaaaaaaaaaaaaaaaaaaaaaaaaaaa
aaaaaaaaaaaaaaaaaaaaaaaaaaaaaaaaaaaaaaaaaaaaaaaaaaaaaaaaaaaaaaaaaaaaaaaaaaaaaaaaaaaaaaaaaaaaaaaaaaaaaaaaaaaaaaaaaaaaaaaaaaaaaaaaaaaaaaaaaaaa
aaaaaaaaaaaaaaaaaaaaaaaaaaaaaaaaaaaaaaaaaaaaaaaaaaaaaaaaaaaaaaaaaaaaaaaaaaaaaaaaaaaaaaaaaaaaaaaaaaaaaaaaaaaaaaaaaaaaaaaaaaaaaaaaaaaaaaaaaaaa
aaaaaaaaaaaaaaaaaaaaaaaaaaaaaaaaaaaaaaaaaaaaaaaaaaaaaaaaaaaaaaaaaaaaaaaaaaaaaaaaaaaaaaaaaaaaaaaaaaaaaaaaaaaaaaaaaaaaaaaaaaaaaaaaaaaaaaaaaaaa
aaaaaaaaaaaaaaaaaaaaaaaaaaaaaaaaaaaaaaaaaaaaaaaaaaaaaaaaaaaaaaaaaaaaaaaaaaaaaaaaaaaaaaaaaaaaaaaaaaaaaaaaaaaaaaaaaaaaaaaaaaaaaaaaaaaaaaaaaaaa
aaaaaaaaaaaaaaaaaaaaaaaaaaaaaaaaaaaaaaaaaaaaaaaaaaaaaaaaaaaaaaaaaaaaaaaaaaaaaaaaaaaaaaaaaaaaaaaaaaaaaaaaaaaaaaaaaaaaaaaaaaaaaaaaaaaaaaaaaaaa
aaaaaaaaaaaaaaaaaaaaaaaaaaaaaaaaaaaaaaaaaaaaaaaaaaaaaaaaaaaaaaaaaaaaaaaaaaaaaaaaaaaaaaaaaaaaaaaaaaaaaaaaaaaaaaaaaaaaaaaaaaaaaaaaaaaaaaaaaaaa
aaaaaaaaaaaaaaaaaaaaaaaaaaaaaaaaaaaaaaaaaaaaaaaaaaaaaaaaaaaaaaaaaaaaaaaaaaaaaaaaaaaaaaaaaaaaaaaaaaaaaaaaaaaaaaaaaaaaaaaaaaaaaaaaaaaaaaaaaaaa
aaaaaaaaaaaaaaaaaaaaaaaaaaaaaaaaaaaaaaaaaaaaaaaaaaaaaaaaaaaaaaaaaaaaaaaaaaaaaaaaaaaaaaaaaaaaaaaaaaaaaaaaaaaaaaaaaaaaaaaaaaaaaaaaaaaaaaaaaaaa
aaaaaaaaaaaaaaaaaaaaaaaaaaaaaaaaaaaaaaaaaaaaaaaaaaaaaaaaaaaaaaaaaaaaaaaaaaaaaaaaaaaaaaaaaaaaaaaaaaaaaaaaaaaaaaaaaaaaaaaaaaaaaaaaaaaaaaaaaaaa
aaaaaaaaaaaaaaaaaaaaaaaaaaaaaaaaaaaaaaaaaaaaaaaaaaaaaaaaaaaaaaaaaaaaaaaaaaaaaaaaaaaaaaaaaaaaaaaaaaaaaaaaaaaaaaaaaaaaaaaaaaaaaaaaaaaaaaaaaaaa
aaaaaaaaaaaaaaaaaaaaaaaaaaaaaaaaaaaaaaaaaaaaaaaaaaaaaaaaaaaaaaaaaaaaaaaaaaaaaaaaaaaaaaaaaaaaaaaaaaaaaaaaaaaaaaaaaaaaaaaaaaaaaaaaaaaaaaaaaaaa
aaaaaaaaaaaaaaaaaaaaaaaaaaaaaaaaaaaaaaaaaaaaaaaaaaaaaaaaaaaaaaaaaaaaaaaaaaaaaaaaaaaaaaaaaaaaaaaaaaaaaaaaaaaaaaaaaaaaaaaaaaaaaaaaaaaaaaaaaaaa
aaaaaaaaaaaaaaaaaaaaaaaaaaaaaaaaaaaaaaaaaaaaaaaaaaaaaaaaaaaaaaaaaaaaaaaaaaaaaaaaaaaaaaaaaaaaaaaaaaaaaaaaaaaaaaaaaaaaaaaaaaaaaaaaaaaaaaaaaaaa
aaaaaaaaaaaaaaaaaaaaaaaaaaaaaaaaaaaaaaaaaaaaaaaaaaaaaaaaaaaaaaaaaaaaaaaaaaaaaaaaaaaaaaaaaaaaaaaaaaaaaaaaaaaaaaaaaaaaaaaaaaaaaaaaaaaaaaaaaaaa
aaaaaaaaaaaaaaaaaaaaaaaaaaaaaaaaaaaaaaaaaaaaaaaaaaaaaaaaaaaaaaaaaaaaaaaaaaaaaaaaaaaaaaaaaaaaaaaaaaaaaaaaaaaaaaaaaaaaaaaaaaaaaaaaaaaaaaaaaaaa
aaaaaaaaaaaaaaaaaaaaaaaaaaaaaaaaaaaaaaaaaaaaaaaaaaaaaaaaaaaaaaaaaaaaaaaaaaaaaaaaaaaaaaaaaaaaaaaaaaaaaaaaaaaaaaaaaaaaaaaaaaaaaaaaaaaaaaaaaaaa
aaaaaaaaaaaaaaaaaaaaaaaaaaaaaaaaaaaaaaaaaaaaaaaaaaaaaaaaaaaaaaaaaaaaaaaaaaaaaaaaaaaaaaaaaaaaaaaaaaaaaaaaaaaaaaaaaaaaaaaaaaaaaaaaaaaaaaaaaaaa
aaaaaaaaaaaaaaaaaaaaaaaaaaaaaaaaaaaaaaaaaaaaaaaaaaaaaaaaaaaaaaaaaaaaaaaaaaaaaaaaaaaaaaaaaaaaaaaaaaaaaaaaaaaaaaaaaaaaaaaaaaaaaaaaaaaaaaaaaaaa
aaaaaaaaaaaaaaaaaaaaaaaaaaaaaaaaaaaaaaaaaaaaaaaaaaaaaaaaaaaaaaaaaaaaaaaaaaaaaaaaaaaaaaaaaaaaaaaaaaaaaaaaaaaaaaaaaaaaaaaaaaaaaaaaaaaaaaaaaaaa
aaaaaaaaaaaaaaaaaaaaaaaaaaaaaaaaaaaaaaaaaaaaaaaaaaaaaaaaaaaaaaaaaaaaaaaaaaaaaaaaaaaaaaaaaaaaaaaaaaaaaaaaaaaaaaaaaaaaaaaaaaaaaaaaaaaaaaaaaaaa
aaaaaaaaaaaaaaaaaaaaaaaaaaaaaaaaaaaaaaaaaaaaaaaaaaaaaaaaaaaaaaaaaaaaaaaaaaaaaaaaaaaaaaaaaaaaaaaaaaaaaaaaaaaaaaaaaaaaaaaaaaaaaaaaaaaaaaaaaaaa
aaaaaaaaaaaaaaaaaaaaaaaaaaaaaaaaaaaaaaaaaaaaaaaaaaaaaaaaaaaaaaaaaaaaaaaaaaaaaaaaaaaaaaaaaaaaaaaaaaaaaaaaaaaaaaaaaaaaaaaaaaaaaaaaaaaaaaaaaaaa
aaaaaaaaaaaaaaaaaaaaaaaaaaaaaaaaaaaaaaaaaaaaaaaaaaaaaaaaaaaaaaaaaaaaaaaaaaaaaaaaaaaaaaaaaaaaaaaaaaaaaaaaaaaaaaaaaaaaaaaaaaaaaaaaaaaaaaaaaaaa
aaaaaaaaaaaaaaaaaaaaaaaaaaaaaaaaaaaaaaaaaaaaaaaaaaaaaaaaaaaaaaaaaaaaaaaaaaaaaaaaaaaaaaaaaaaaaaaaaaaaaaaaaaaaaaaaaaaaaaaaaaaaaaaaaaaaaaaaaaaa
aaaaaaaaaaaaaaaaaaaaaaaaaaaaaaaaaaaaaaaaaaaaaaaaaaaaaaaaaaaaaaaaaaaaaaaaaaaaaaaaaaaaaaaaaaaaaaaaaaaaaaaaaaaaaaaaaaaaaaaaaaaaaaaaaaaaaaaaaaaa
aaaaaaaaaaaaaaaaaaaaaaaaaaaaaaaaaaaaaaaaaaaaaaaaaaaaaaaaaaaaaaaaaaaaaaaaaaaaaaaaaaaaaaaaaaaaaaaaaaaaaaaaaaaaaaaaaaaaaaaaaaaaaaaaaaaaaaaaaaaa
aaaaaaaaaaaaaaaaaaaaaaaaaaaaaaaaaaaaaaaaaaaaaaaaaaaaaaaaaaaaaabzbzbzaaaaaaaaaaaaaaaaaaaaaaaaaaaaaaaaaaaaaaaaaaaaaaaaaaaaaaaaaaaaaaaaaaaaaaaa
aaaaaaaaaaaaaaaaaaaaaaaaaaaaaaaaaaaaaaaaaaaaaaaaaaaaaaaaaaaaabbzbcbzabaaaaaaaaaaaaaaaaaaaaaaaaaaaaaaaaaaaaaaaaaaaaaaaaaaaaaaaaaaaaaaaaaaaaaa
aaaaaaaaaaaaaaaaaaaaaaaaaaaaaaaaaaaaaaaaaaaaaaaaaaaaaaaaaabAbzbfaebvbzbAaaaaaaaaaaaaaaaaaaaaaaaaaaaaaaaaaaaaaaaaaaaaaaaaaaaaaaaaaaaaaaaaaaaa
aaaaaaaaaaaaaaaaaaaaaaaaaaaaaaaaaaaaaaaaaaaaaaaaaaaaaaaaaabAabbhadbjabbAaaaaaaaaaaaaaaaaaaaaaaaaaaaaaaaaaaaaaaaaaaaaaaaaaaaaaaaaaaaaaaaaaaaa
aaaaaaaaaaaaaaaaaaaaaaaaaaaaaaaaaaaaaaaaaaaaaaaaaaaaaaaabAabababafabababbAaaaaaaaaaaaaaaaaaaaaaaaaaaaaaaaaaaaaaaaaaaaaaaaaaaaaaaaaaaaaaaaaaa
aaaaaaaaaaaaaaaaaaaaaaaaaaaaaaaaaaaaaaaaaaaaaaaaaaaaaabAababagabahabbgababbAaaaaaaaaaaaaaaaaaaaaaaaaaaaaaaaaaaaaaaaaaaaaaaaaaaaaaaaaaaaaaaaa
aaaaaaaaaaaaaaaaaaaaaaaaaaaaaaaaaaaaaaaaaaaaaaaaaaaaaabAabbbajakadakanbpabbAaaaaaaaaaaaaaaaaaaaaaaaaaaaaaaaaaaaaaaaaaaaaaaaaaaaaaaaaaaaaaaaa
aaaaaaaaaaaaaaaaaaaaaaaaaaaaaaaaaaaaaaaaaaaaaaaaaaaaaabsababababafababababbwaaaaaaaaaaaaaaaaaaaaaaaaaaaaaaaaaaaaaaaaaaaaaaaaaaaaaaaaaaaaaaaa
aaaaaaaaaaaaaaaaaaaaaaaaaaaaaaaaaaaaaaaaaaaaaaaaaaaaabababaoapaqarasbdatabababaaaaaaaaaaaaaaaaaaaaaaaaaaaaaaaaaaaaaaaaaaaaaaaaaaaaaaaaaaaaaa
aaaaaaaaaaaaaaaaaaaaaaaaaaaaaaaaaaaaaaaaaaaaaaaaaaababbxabadavalaxaiayadabauababaaaaaaaaaaaaaaaaaaaaaaaaaaaaaaaaaaaaaaaaaaaaaaaaaaaaaaaaaaaa
aaaaaaaaaaaaaaaaaaaaaaaaaaaaaaaaaaaaaaaaaaaaaaaaaaabbMbQakbRazbPbnaiazbRakawaEabaaaaaaaaaaaaaaaaaaaaaaaaaaaaaaaaaaaaaaaaaaaaaaaaaaaaaaaaaaaa
aaaaaaaaaaaaaaaaaaaaaaaaaaaaaaaaaaaaaaaaaaaaaaaaaaabblblabbSaAambeaiaBbTabaLaMabaaaaaaaaaaaaaaaaaaaaaaaaaaaaaaaaaaaaaaaaaaaaaaaaaaaaaaaaaaaa
aaaaaaaaaaaaaaaaaaaaaaaaaaaaaaaaaaaaaaaaaaaaaaaaaaababababbWaAaCaDaNaBbUabaLaOabaaaaaaaaaaaaaaaaaaaaaaaaaaaaaaaaaaaaaaaaaaaaaaaaaaaaaaaaaaaa
aaaaaaaaaaaaaaaaaaaaaaaaaaaaaaaaaaaaaaaaaaaaaaaaaaabaPadakbRaHaFacaGaHbRakaLaQabaaaaaaaaaaaaaaaaaaaaaaaaaaaaaaaaaaaaaaaaaaaaaaaaaaaaaaaaaaaa
aaaaaaaaaaaaaaaaaaaaaaaaaaaaaaaaaaaaaaaaaaaaaaaaaaabaRaSabadaUaFacaGaVadabaWaXabaaaaaaaaaaaaaaaaaaaaaaaaaaaaaaaaaaaaaaaaaaaaaaaaaaaaaaaaaaaa
aaaaaaaaaaaaaaaaaaaaaaaaaaaaaaaaaaaaaaaaaaaaaaaaaaababababafabaIaJaKabafababababaaaaaaaaaaaaaaaaaaaaaaaaaaaaaaaaaaaaaaaaaaaaaaaaaaaaaaaaaaaa
aaaaaaaaaaaaaaaaaaaaaaaaaaaaaaaaaaaaaaaaaaaaaaaaaabEabaYadbXabafafafabbYadbKabbGaaaaaaaaaaaaaaaaaaaaaaaaaaaaaaaaaaaaaaaaaaaaaaaaaaaaaaaaaaaa
aaaaaaaaaaaaaaaaaaaaaaaaaaaaaaaaaaaaaaaaaaaaaaaaaabAabadadbaabaTaTaTabaZadadabbAaaaaaaaaaaaaaaaaaaaaaaaaaaaaaaaaaaaaaaaaaaaaaaaaaaaaaaaaaaaa
aaaaaaaaaaaaaaaaaaaaaaaaaaaaaaaaaaaaaaaaaaaaaaaaaaaaabababababaTaTaTabababababaaaaaaaaaaaaaaaaaaaaaaaaaaaaaaaaaaaaaaaaaaaaaaaaaaaaaaaaaaaaaa
aaaaaaaaaaaaaaaaaaaaaaaaaaaaaaaaaaaaaaaaaaaaaaaaaaaaabbFbFbFabafafafabbFbFbFabaaaaaaaaaaaaaaaaaaaaaaaaaaaaaaaaaaaaaaaaaaaaaaaaaaaaaaaaaaaaaa
aaaaaaaaaaaaaaaaaaaaaaaaaaaaaaaaaaaaaaaaaaaaaaaaaaaaaaaaaaaaaaaaaaaaaaaaaaaaaaaaaaaaaaaaaaaaaaaaaaaaaaaaaaaaaaaaaaaaaaaaaaaaaaaaaaaaaaaaaaaa
aaaaaaaaaaaaaaaaaaaaaaaaaaaaaaaaaaaaaaaaaaaaaaaaaaaaaaaaaaaaaaaaaaaaaaaaaaaaaaaaaaaaaaaaaaaaaaaaaaaaaaaaaaaaaaaaaaaaaaaaaaaaaaaaaaaaaaaaaaaa
aaaaaaaaaaaaaaaaaaaaaaaaaaaaaaaaaaaaaaaaaaaaaaaaaaaaaaaaaaaaaaaaaaaaaaaaaaaaaaaaaaaaaaaaaaaaaaaaaaaaaaaaaaaaaaaaaaaaaaaaaaaaaaaaaaaaaaaaaaaa
aaaaaaaaaaaaaaaaaaaaaaaaaaaaaaaaaaaaaaaaaaaaaaaaaaaaaaaaaaaaaaaaaaaaaaaaaaaaaaaaaaaaaaaaaaaaaaaaaaaaaaaaaaaaaaaaaaaaaaaaaaaaaaaaaaaaaaaaaaaa
aaaaaaaaaaaaaaaaaaaaaaaaaaaaaaaaaaaaaaaaaaaaaaaaaaaaaaaaaaaaaaaaaaaaaaaaaaaaaaaaaaaaaaaaaaaaaaaaaaaaaaaaaaaaaaaaaaaaaaaaaaaaaaaaaaaaaaaaaaaa
aaaaaaaaaaaaaaaaaaaaaaaaaaaaaaaaaaaaaaaaaaaaaaaaaaaaaaaaaaaaaaaaaaaaaaaaaaaaaaaaaaaaaaaaaaaaaaaaaaaaaaaaaaaaaaaaaaaaaaaaaaaaaaaaaaaaaaaaaaaa
aaaaaaaaaaaaaaaaaaaaaaaaaaaaaaaaaaaaaaaaaaaaaaaaaaaaaaaaaaaaaaaaaaaaaaaaaaaaaaaaaaaaaaaaaaaaaaaaaaaaaaaaaaaaaaaaaaaaaaaaaaaaaaaaaaaaaaaaaaaa
aaaaaaaaaaaaaaaaaaaaaaaaaaaaaaaaaaaaaaaaaaaaaaaaaaaaaaaaaaaaaaaaaaaaaaaaaaaaaaaaaaaaaaaaaaaaaaaaaaaaaaaaaaaaaaaaaaaaaaaaaaaaaaaaaaaaaaaaaaaa
aaaaaaaaaaaaaaaaaaaaaaaaaaaaaaaaaaaaaaaaaaaaaaaaaaaaaaaaaaaaaaaaaaaaaaaaaaaaaaaaaaaaaaaaaaaaaaaaaaaaaaaaaaaaaaaaaaaaaaaaaaaaaaaaaaaaaaaaaaaa
aaaaaaaaaaaaaaaaaaaaaaaaaaaaaaaaaaaaaaaaaaaaaaaaaaaaaaaaaaaaaaaaaaaaaaaaaaaaaaaaaaaaaaaaaaaaaaaaaaaaaaaaaaaaaaaaaaaaaaaaaaaaaaaaaaaaaaaaaaaa
aaaaaaaaaaaaaaaaaaaaaaaaaaaaaaaaaaaaaaaaaaaaaaaaaaaaaaaaaaaaaaaaaaaaaaaaaaaaaaaaaaaaaaaaaaaaaaaaaaaaaaaaaaaaaaaaaaaaaaaaaaaaaaaaaaaaaaaaaaaa
aaaaaaaaaaaaaaaaaaaaaaaaaaaaaaaaaaaaaaaaaaaaaaaaaaaaaaaaaaaaaaaaaaaaaaaaaaaaaaaaaaaaaaaaaaaaaaaaaaaaaaaaaaaaaaaaaaaaaaaaaaaaaaaaaaaaaaaaaaaa
aaaaaaaaaaaaaaaaaaaaaaaaaaaaaaaaaaaaaaaaaaaaaaaaaaaaaaaaaaaaaaaaaaaaaaaaaaaaaaaaaaaaaaaaaaaaaaaaaaaaaaaaaaaaaaaaaaaaaaaaaaaaaaaaaaaaaaaaaaaa
aaaaaaaaaaaaaaaaaaaaaaaaaaaaaaaaaaaaaaaaaaaaaaaaaaaaaaaaaaaaaaaaaaaaaaaaaaaaaaaaaaaaaaaaaaaaaaaaaaaaaaaaaaaaaaaaaaaaaaaaaaaaaaaaaaaaaaaaaaaa
aaaaaaaaaaaaaaaaaaaaaaaaaaaaaaaaaaaaaaaaaaaaaaaaaaaaaaaaaaaaaaaaaaaaaaaaaaaaaaaaaaaaaaaaaaaaaaaaaaaaaaaaaaaaaaaaaaaaaaaaaaaaaaaaaaaaaaaaaaaa
aaaaaaaaaaaaaaaaaaaaaaaaaaaaaaaaaaaaaaaaaaaaaaaaaaaaaaaaaaaaaaaaaaaaaaaaaaaaaaaaaaaaaaaaaaaaaaaaaaaaaaaaaaaaaaaaaaaaaaaaaaaaaaaaaaaaaaaaaaaa
aaaaaaaaaaaaaaaaaaaaaaaaaaaaaaaaaaaaaaaaaaaaaaaaaaaaaaaaaaaaaaaaaaaaaaaaaaaaaaaaaaaaaaaaaaaaaaaaaaaaaaaaaaaaaaaaaaaaaaaaaaaaaaaaaaaaaaaaaaaa
aaaaaaaaaaaaaaaaaaaaaaaaaaaaaaaaaaaaaaaaaaaaaaaaaaaaaaaaaaaaaaaaaaaaaaaaaaaaaaaaaaaaaaaaaaaaaaaaaaaaaaaaaaaaaaaaaaaaaaaaaaaaaaaaaaaaaaaaaaaa
aaaaaaaaaaaaaaaaaaaaaaaaaaaaaaaaaaaaaaaaaaaaaaaaaaaaaaaaaaaaaaaaaaaaaaaaaaaaaaaaaaaaaaaaaaaaaaaaaaaaaaaaaaaaaaaaaaaaaaaaaaaaaaaaaaaaaaaaaaaa
aaaaaaaaaaaaaaaaaaaaaaaaaaaaaaaaaaaaaaaaaaaaaaaaaaaaaaaaaaaaaaaaaaaaaaaaaaaaaaaaaaaaaaaaaaaaaaaaaaaaaaaaaaaaaaaaaaaaaaaaaaaaaaaaaaaaaaaaaaaa
aaaaaaaaaaaaaaaaaaaaaaaaaaaaaaaaaaaaaaaaaaaaaaaaaaaaaaaaaaaaaaaaaaaaaaaaaaaaaaaaaaaaaaaaaaaaaaaaaaaaaaaaaaaaaaaaaaaaaaaaaaaaaaaaaaaaaaaaaaaa
aaaaaaaaaaaaaaaaaaaaaaaaaaaaaaaaaaaaaaaaaaaaaaaaaaaaaaaaaaaaaaaaaaaaaaaaaaaaaaaaaaaaaaaaaaaaaaaaaaaaaaaaaaaaaaaaaaaaaaaaaaaaaaaaaaaaaaaaaaaa
aaaaaaaaaaaaaaaaaaaaaaaaaaaaaaaaaaaaaaaaaaaaaaaaaaaaaaaaaaaaaaaaaaaaaaaaaaaaaaaaaaaaaaaaaaaaaaaaaaaaaaaaaaaaaaaaaaaaaaaaaaaaaaaaaaaaaaaaaaaa
"}
